8 8
1 6
WWWWWWWW
W  W   W
W  W   W
W WWW  W
W W    W
W   WW W
W W W  W
WWWWWWWW